31 31 31 32 31 31 31 31 31 32 31 31 32 31 32 31 31 31 31 31 32 31 31 31 32 31 31 31 32 31 31 31 31 31 31 31 31 32 31 31 31 31 31 32 31 31 31 31 31 31
31 32 31 31 32 31 31 32 31 31 31 31 31 31 31 31 31 32 31 31 31 32 31 31 31 31 32 31 32 31 32 31 31 31 32 31 31 31 32 31 31 32 31 31 31 31 31 31 31 31
31 31 31 31 31 31 31 31 32 31 31 31 31 32 31 31 31 31 32 31 31 31 32 31 31 31 31 31 31 31 31 31 31 31 31 31 31 31 31 31 31 31 31 31 31 32 31 31 31 31
25 25 25 25 25 25 25 25 25 25 25 25 25 25 25 25 25 25 25 25 25 25 25 25 25 25 25 25 25 25 25 25 25 25 25 25 25 25 25 25 25 25 31 31 31 31 31 33 31 31
55 55 55 56 22 22 22 24 24 24 24 24 24 24 24 24 24 24 24 24 24 24 24 24 24 24 24 24 24 24 24 24 24 24 24 24 24 24 24 24 24 24 26 31 31 31 31 31 31 31
55 55 55 56 21 21 21 22 22 22 22 22 22 22 22 22 22 22 22 22 22 22 22 22 22 22 22 22 22 22 22 22 22 22 22 22 22 22 22 23 24 24 26 31 31 31 31 31 31 31
55 55 55 56 21 21 21 21 21 21 21 21 21 21 65 21 21 21 21 21 21 21 21 21 21 21 21 21 21 21 21 21 21 21 21 21 21 21 21 23 24 24 26 31 31 33 31 31 31 31
95 55 55 56 21 21 21 21 21 21 21 21 21 21 66 21 21 21 21 21 65 21 21 21 21 21 21 21 21 21 21 21 21 65 21 21 21 65 21 23 24 24 26 31 31 31 31 31 31 31
55 55 55 56 21 21 21 21 21 65 21 21 21 21 21 21 21 21 21 21 66 21 21 21 65 21 21 21 21 21 21 21 21 66 21 21 21 66 21 23 24 24 26 31 31 31 31 31 31 31
95 55 55 56 21 21 21 21 21 66 21 21 21 21 21 21 21 21 21 21 21 21 21 21 66 21 21 21 21 21 21 21 21 21 21 21 21 21 21 23 24 24 26 31 31 31 31 31 33 31
55 55 55 56 21 21 21 21 21 21 21 21 21 21 21 21 21 21 21 21 21 21 21 21 21 21 21 21 21 21 21 21 21 21 21 21 21 21 21 23 24 24 26 31 31 31 31 31 31 31
55 55 55 56 21 21 21 21 21 21 21 21 21 21 21 21 21 21 21 21 21 21 21 21 21 21 21 21 21 21 21 21 21 21 21 21 21 21 21 23 24 24 26 31 31 31 31 31 31 31
55 55 55 56 21 21 21 21 21 21 21 21 21 21 21 21 21 21 21 21 21 21 21 21 21 21 21 21 21 21 21 21 21 21 21 21 21 21 21 23 24 24 26 31 31 31 31 31 31 31
55 55 55 56 21 21 21 21 21 21 21 21 21 21 21 21 21 21 21 21 21 21 21 21 21 21 21 21 21 21 21 21 21 21 21 21 21 21 21 23 24 24 26 31 31 31 31 31 31 31
95 55 55 56 21 21 21 21 21 21 21 21 21 21 21 21 21 21 21 21 21 21 21 21 21 21 21 21 21 21 21 21 21 21 21 21 21 21 21 23 24 24 26 31 31 31 31 31 31 31
55 55 55 56 21 65 21 21 21 21 21 21 21 21 21 21 21 65 21 21 21 21 21 65 21 21 21 21 21 21 21 21 21 21 21 21 21 21 21 23 24 24 26 31 31 31 31 31 31 31
95 55 55 56 21 66 21 21 21 21 21 21 21 21 65 21 21 66 21 21 21 21 21 66 21 21 21 21 21 21 21 21 21 21 21 65 21 21 21 23 24 24 26 31 33 31 31 31 33 31
55 55 55 56 65 21 21 21 21 21 21 65 21 21 66 21 21 21 21 21 21 21 21 21 21 21 21 21 21 21 21 21 21 21 21 66 21 21 21 23 24 24 26 31 31 31 31 31 31 31
55 55 55 56 66 21 21 21 21 21 21 21 21 21 21 21 21 21 21 21 21 21 21 21 21 21 21 21 21 21 21 21 21 21 21 21 21 21 21 23 24 24 26 31 31 33 31 31 31 31
95 55 55 56 65 21 21 21 21 21 21 21 21 21 21 21 21 21 21 21 21 21 21 21 21 21 21 21 21 21 21 21 21 21 21 21 21 65 21 23 24 24 26 31 31 31 31 31 31 31
55 55 55 56 66 21 21 21 21 21 21 21 21 21 21 21 21 21 21 21 21 21 21 21 21 21 21 21 21 21 21 21 21 21 21 21 21 66 21 23 24 24 26 31 31 33 31 33 31 31
95 55 55 56 65 21 21 21 21 21 21 21 21 21 21 21 21 21 21 21 65 21 21 21 21 21 21 21 21 21 21 21 21 21 21 21 21 21 21 23 24 24 26 31 31 31 31 31 31 31
55 55 55 56 66 21 21 21 21 21 21 21 21 21 21 21 21 21 21 21 66 21 21 21 21 21 21 21 21 21 21 21 21 21 21 21 21 21 21 23 24 24 26 31 31 31 31 31 31 31
95 55 55 56 65 21 21 21 21 21 21 65 21 21 21 21 21 21 21 21 21 21 21 21 21 21 21 21 21 21 21 21 21 21 21 21 21 21 21 23 24 24 26 31 31 31 31 31 33 31
55 55 55 56 66 21 21 21 21 21 21 66 21 21 21 21 21 21 21 21 21 21 21 21 21 21 21 21 21 21 21 21 21 21 21 21 21 21 65 23 24 24 26 31 31 33 31 31 31 31
95 55 55 56 21 21 21 21 21 21 21 21 21 21 21 21 21 21 21 21 21 21 21 21 21 21 21 21 21 21 21 21 21 21 21 21 21 21 66 23 24 24 26 31 31 31 31 31 33 31
55 55 55 56 65 21 21 21 21 21 21 65 21 21 21 21 21 21 21 21 21 21 21 21 21 21 21 21 21 21 21 21 21 21 21 21 21 21 21 23 24 24 26 31 31 31 31 31 31 31
95 55 55 56 66 21 21 21 21 21 21 66 21 21 75 75 75 75 75 75 75 75 75 75 75 75 75 75 75 21 21 21 21 21 21 21 21 21 21 23 24 24 26 31 33 31 31 31 31 31
55 55 55 56 65 21 21 21 21 21 21 21 21 21 75 21 21 57 57 57 21 21 21 57 57 57 21 21 75 21 21 21 21 21 21 21 21 21 65 23 24 24 26 31 31 31 31 31 31 31
95 55 55 56 66 21 21 21 21 21 21 21 21 21 75 21 57 55 55 55 57 21 57 55 55 55 57 21 75 21 21 21 21 21 21 21 21 21 66 23 24 24 26 31 31 31 31 33 31 31
55 55 55 56 21 65 21 21 21 21 21 21 21 21 75 57 55 55 55 55 55 57 55 55 55 55 55 57 75 21 21 21 21 21 21 21 21 21 21 23 24 24 26 31 33 31 31 31 31 31
55 95 55 56 21 66 21 21 21 21 21 21 21 21 75 55 55 55 55 55 55 55 55 55 55 55 55 55 75 75 21 21 21 21 21 21 21 21 65 23 24 24 26 31 31 31 31 31 31 31
55 55 55 56 21 21 21 21 21 21 21 21 21 21 75 55 55 55 55 55 55 55 55 55 55 55 55 55 21 75 21 21 21 21 21 21 21 21 66 23 24 24 26 31 31 31 31 31 31 31
95 55 55 56 21 21 21 21 21 21 21 21 21 21 75 58 55 55 55 55 55 55 55 55 55 55 55 56 21 21 21 21 21 21 21 21 21 21 21 23 24 24 26 31 31 31 31 33 31 31
55 55 55 56 21 65 21 21 21 21 21 21 21 21 75 21 58 55 55 55 55 55 55 55 55 55 56 21 21 21 21 21 21 21 21 21 21 21 21 21 23 24 26 31 31 33 31 31 31 31
55 55 55 56 21 66 21 21 21 21 21 21 21 21 75 21 21 58 55 55 55 55 55 55 55 56 21 21 21 75 21 21 21 21 21 21 21 65 21 21 23 24 26 31 31 31 31 31 31 31
55 55 55 56 21 21 21 21 21 21 21 21 21 21 75 21 21 21 58 55 55 55 55 55 56 21 21 21 75 75 21 21 21 21 21 21 21 66 21 21 23 24 26 31 31 31 31 31 31 31
95 55 55 56 21 21 65 21 21 21 21 21 21 21 75 21 21 21 21 58 55 55 55 56 21 21 21 21 75 21 21 21 21 21 21 21 21 21 21 21 23 24 26 31 31 31 31 31 31 31
55 95 55 56 21 21 66 21 21 21 21 21 21 21 75 21 21 21 21 21 58 55 56 21 21 21 21 21 75 21 21 21 21 21 21 21 21 65 21 21 23 24 26 31 31 33 31 33 31 31
55 55 55 55 55 56 21 21 21 21 21 21 21 21 75 21 21 21 21 21 21 59 21 21 21 21 21 21 75 21 21 21 21 21 21 21 21 66 21 21 23 24 26 31 31 31 31 31 31 31
55 55 55 55 55 56 65 21 21 21 21 21 21 21 75 75 75 75 75 75 75 75 75 75 75 75 75 75 75 21 21 21 21 21 21 21 21 21 21 21 23 24 26 31 31 31 31 31 31 31
95 55 55 55 55 56 66 21 21 21 21 21 21 21 21 21 21 21 21 21 21 21 21 21 21 21 21 21 21 21 21 21 21 21 21 21 21 65 21 21 23 24 26 31 31 31 31 31 31 31
55 55 55 55 55 56 21 65 21 21 21 21 21 21 21 21 21 21 21 21 21 21 21 21 21 21 21 21 21 21 21 21 21 21 21 21 21 66 21 21 23 24 26 31 33 31 31 31 31 31
55 55 55 55 55 56 21 66 21 21 21 21 21 21 21 21 21 21 21 21 21 21 21 21 21 21 21 21 21 21 21 21 21 21 21 21 21 21 65 21 23 24 26 31 31 31 31 31 31 31
55 95 55 55 55 55 56 21 21 21 21 21 21 65 21 21 21 21 21 21 21 21 21 21 21 21 21 21 21 21 21 21 21 21 21 21 21 21 66 21 23 24 26 31 31 31 33 31 33 31
55 55 55 55 55 55 56 21 21 65 21 65 21 66 21 65 21 21 21 65 21 21 65 21 21 21 65 21 21 21 65 21 65 21 21 21 65 21 21 21 23 24 26 31 33 31 31 31 31 31
95 95 55 55 55 55 56 21 21 66 21 66 21 66 21 66 21 21 21 66 21 21 66 21 21 21 66 21 21 21 66 21 66 21 21 21 66 21 21 21 21 21 26 31 31 31 31 31 31 31
95 95 55 55 55 55 55 57 57 57 57 57 57 57 57 57 57 57 57 57 57 57 57 57 57 57 57 57 57 57 57 57 57 57 57 57 57 57 57 57 57 57 26 31 31 31 31 31 31 31
95 95 95 95 55 55 55 55 55 55 55 55 55 55 55 55 55 55 55 55 55 55 55 55 55 55 55 55 55 55 55 55 55 55 55 55 55 55 55 55 55 55 55 31 31 31 31 31 31 31
95 95 95 95 95 95 55 55 55 55 55 55 55 55 55 55 95 55 55 55 95 55 55 55 55 55 55 55 55 95 55 55 55 55 55 55 55 55 55 95 55 55 95 31 31 31 31 31 31 31