11 41 42 12 11 12 11 20 20 20 20 20 20 20 11 12 11 12 11 12 11 30 30 30 30 12 41 42 11 12 11 41 42 12 71 72 41 42 11 71 72 41 42 20 20 20 20 12 71 72
12 43 44 11 12 11 12 20 20 20 20 20 20 20 12 11 12 11 12 11 12 30 30 30 30 11 43 44 12 11 12 43 44 11 73 74 43 44 12 73 74 43 44 20 20 20 20 11 73 74
11 45 46 12 11 12 11 20 20 20 20 20 20 20 11 12 11 12 11 12 11 30 30 30 30 12 45 46 11 12 11 45 46 12 11 12 45 46 11 12 11 45 46 20 20 20 20 12 11 12
12 47 48 11 12 11 12 20 20 20 20 20 20 20 12 11 12 11 12 11 12 30 30 30 30 11 47 48 12 11 12 47 48 11 12 11 47 48 12 11 12 47 48 20 20 20 20 11 12 11
11 12 11 12 11 12 11 20 20 20 20 20 20 20 11 12 11 12 11 12 11 30 30 30 30 12 11 12 11 12 11 12 11 12 11 12 11 12 11 12 11 12 11 20 20 20 20 12 11 12
41 42 12 11 12 11 12 20 20 20 20 20 20 20 12 11 12 11 12 11 12 30 30 30 30 11 12 11 12 11 12 11 12 11 12 11 12 11 12 41 42 11 12 20 20 20 20 11 71 72
43 44 11 12 11 12 11 20 20 20 20 20 20 20 11 12 11 12 11 12 11 30 30 30 30 12 11 12 11 12 11 12 11 12 11 12 11 12 11 43 44 12 11 20 20 20 20 12 73 74
45 46 12 11 12 11 12 20 20 20 20 20 20 20 12 11 12 11 12 11 12 30 30 30 30 11 12 11 12 11 12 11 12 11 12 11 12 11 12 45 46 11 12 20 20 20 20 11 12 11
47 48 11 12 11 12 11 20 20 20 20 20 20 20 11 12 11 12 11 12 11 30 30 30 30 12 11 12 11 12 11 12 11 12 11 12 11 12 11 47 48 12 11 20 20 20 20 12 11 12
12 11 12 11 12 11 12 20 20 20 20 20 20 20 20 11 12 11 12 11 12 30 30 30 30 11 12 11 12 11 12 11 12 11 12 11 12 11 12 11 12 11 12 20 20 20 20 11 12 11
91 92 11 12 11 12 11 20 20 20 20 20 20 20 20 12 11 12 11 30 30 30 30 30 30 12 11 12 11 12 11 12 11 12 11 12 11 12 11 12 11 12 11 20 20 20 20 20 11 12
93 94 12 11 12 11 12 20 20 20 20 20 20 20 20 11 12 11 12 30 30 30 30 30 30 11 12 11 12 11 12 11 12 11 12 11 12 11 12 11 12 11 12 20 20 20 20 20 12 11
11 12 11 12 11 12 11 20 20 20 20 20 20 20 20 12 11 12 11 30 30 30 30 30 30 12 11 12 11 12 11 12 11 12 11 12 11 12 11 12 11 12 11 20 20 20 20 20 11 12
41 42 12 11 12 11 12 20 20 20 20 20 20 20 20 11 12 11 12 30 30 30 30 30 30 11 12 11 12 11 12 11 12 11 12 11 12 11 12 11 12 11 12 20 20 20 20 20 12 11
43 44 11 12 11 12 20 20 20 20 20 20 20 20 20 11 12 11 12 30 30 30 30 30 30 12 11 12 11 12 11 12 11 12 11 12 11 12 11 12 11 12 20 20 20 20 20 20 11 12
45 46 12 11 12 11 20 20 20 20 20 20 20 20 20 12 11 12 11 30 30 30 30 30 30 41 42 41 42 11 12 11 12 11 12 11 12 11 12 11 12 11 20 20 20 20 20 20 12 11
47 48 11 12 11 12 20 20 20 20 20 20 20 20 20 11 12 11 12 30 30 30 30 30 30 43 44 43 44 12 11 12 11 12 11 12 11 12 11 12 11 12 20 20 20 20 20 20 11 12
12 11 12 11 12 11 20 20 20 20 20 20 20 20 20 12 11 12 11 30 30 30 30 30 30 45 46 45 46 11 12 11 12 11 12 11 12 11 12 11 12 11 20 20 20 20 20 20 12 11
11 12 11 12 11 12 20 20 20 20 20 20 20 20 20 11 12 11 12 30 30 30 30 30 30 47 48 47 48 12 11 12 11 12 11 12 11 12 11 12 51 52 20 20 20 20 20 20 11 12
12 11 12 11 12 11 20 20 20 20 20 20 20 20 20 12 11 71 72 30 30 30 30 30 30 11 12 61 62 11 12 11 12 11 12 11 12 11 12 11 53 54 20 20 20 20 20 20 12 11
11 12 11 12 11 12 20 20 20 20 20 20 20 20 20 11 12 73 74 30 30 30 30 30 30 30 11 63 64 12 11 12 11 12 11 12 11 12 11 12 11 20 20 20 20 20 20 20 11 12
41 42 12 11 12 11 20 20 20 20 20 20 20 20 20 11 12 11 12 30 30 30 30 30 30 30 12 11 12 11 12 11 12 11 12 11 12 11 12 11 12 20 20 20 20 20 20 20 12 11
43 44 11 12 11 12 20 20 20 20 20 20 20 20 20 11 12 11 30 30 30 30 30 30 30 30 30 30 30 30 30 30 30 30 30 30 30 30 30 30 11 20 20 20 20 20 20 20 11 12
45 46 12 11 12 11 20 20 20 20 20 20 20 20 20 91 92 12 30 30 30 30 30 30 30 30 30 30 30 30 30 30 30 30 30 30 30 30 30 30 12 11 20 20 20 20 20 20 91 92
47 48 11 12 11 12 20 20 20 20 20 20 20 20 20 93 94 11 30 30 30 30 30 30 30 30 30 30 30 30 30 30 30 30 30 30 30 30 11 12 11 12 20 20 20 20 20 20 93 94
12 11 12 11 12 11 20 20 20 20 20 20 20 20 20 12 11 41 42 30 30 30 30 30 30 30 30 30 30 30 30 30 30 30 30 30 30 30 12 11 12 11 20 20 20 20 20 20 12 11
91 92 11 12 11 12 20 20 20 20 20 20 20 20 20 11 12 43 44 30 30 30 30 30 30 41 42 41 42 12 11 12 11 12 11 12 11 12 11 12 11 12 20 20 20 20 20 20 11 12
93 94 12 11 12 11 20 20 20 20 20 20 20 20 20 61 62 45 46 30 30 30 30 30 30 43 44 43 44 11 12 11 12 11 12 11 12 11 12 11 12 11 20 20 20 20 20 20 61 62
11 12 11 12 11 12 20 20 20 20 20 20 20 20 20 63 64 47 48 30 30 30 30 30 30 45 46 45 46 12 11 12 11 12 11 12 11 12 11 12 11 12 20 20 20 20 20 20 63 64
12 11 12 11 12 20 20 20 20 20 20 20 20 20 20 11 12 11 30 30 30 30 30 30 12 47 48 47 48 11 12 11 12 11 12 11 12 11 12 11 12 20 20 20 20 20 20 20 11 12
41 42 11 12 11 20 20 20 20 20 20 20 20 20 20 12 11 12 30 30 30 30 30 30 11 12 11 12 11 12 11 12 11 12 11 12 11 12 11 12 11 20 20 20 20 20 20 20 12 11
43 44 12 11 12 20 20 20 20 20 20 20 20 20 20 11 12 11 30 30 30 30 12 11 12 11 12 11 12 11 12 11 12 11 12 11 12 11 12 11 12 20 20 20 20 20 20 20 11 12
45 46 11 12 11 20 20 20 20 20 20 20 20 20 20 12 11 12 30 30 30 30 11 12 11 12 11 12 11 12 11 12 11 12 11 12 11 12 11 12 11 20 20 20 20 20 20 20 12 11
47 48 12 11 12 20 20 20 20 20 20 20 20 20 20 11 12 11 30 30 30 30 12 11 12 11 12 11 12 11 12 11 12 11 12 11 12 11 12 11 12 20 20 20 20 20 20 20 11 12
11 12 11 12 11 20 20 20 20 20 20 20 20 20 20 12 11 12 30 30 30 30 11 12 11 12 11 12 11 12 11 12 11 12 11 12 11 12 11 12 11 20 20 20 20 20 20 20 12 11
12 11 12 11 12 20 20 20 20 20 20 20 20 20 20 11 12 11 12 11 30 30 12 11 12 11 12 11 12 11 12 11 12 11 12 11 12 11 12 11 12 20 20 20 20 20 20 20 11 12
11 12 11 12 11 20 20 20 20 20 20 20 11 12 11 12 11 12 11 12 30 30 11 12 11 12 11 12 11 12 11 12 11 12 11 12 11 12 11 12 11 20 20 20 20 11 12 11 12 11
12 11 12 11 12 20 20 20 20 20 20 20 12 11 12 11 12 11 12 11 30 30 12 11 12 11 12 11 12 11 12 11 12 11 12 11 12 11 12 11 12 20 20 20 20 12 11 12 11 12
11 12 11 12 11 20 20 20 20 20 20 20 11 12 11 12 11 12 11 12 30 30 11 12 11 12 11 12 11 12 11 12 11 12 11 12 11 12 11 71 72 20 20 20 20 11 12 11 12 11
12 11 12 11 12 20 20 20 20 20 20 20 12 11 12 11 12 11 12 11 30 30 12 11 12 11 12 11 12 11 12 11 12 11 12 11 12 11 12 73 74 20 20 20 20 12 11 12 11 12
41 42 11 12 11 20 20 20 20 20 20 20 11 12 11 12 11 12 11 12 30 30 11 12 11 41 42 12 11 12 11 12 11 12 11 12 11 12 11 12 11 20 20 20 20 11 12 51 52 11
43 44 12 11 12 20 20 20 20 20 20 20 12 11 12 11 12 11 12 11 30 30 12 11 12 43 44 11 12 11 12 11 12 11 12 11 12 11 12 11 12 20 20 20 20 12 11 53 54 12
45 46 11 12 11 20 20 20 20 20 20 20 11 12 11 12 11 12 11 12 30 30 11 12 11 45 46 12 11 12 11 12 11 12 11 12 11 12 11 12 11 20 20 20 20 11 12 11 12 11
47 48 12 11 12 20 20 20 20 20 20 20 12 11 12 11 12 11 12 11 30 30 12 11 12 47 48 11 12 11 12 11 12 11 12 11 12 11 12 11 12 20 20 20 20 12 11 12 11 12
11 12 11 12 11 20 20 20 20 20 20 20 11 12 11 12 11 12 11 12 30 30 11 12 41 42 11 12 41 42 11 12 11 12 11 41 42 12 11 12 11 20 20 20 20 11 12 11 12 11
12 11 12 11 12 20 20 20 20 20 20 20 41 42 12 11 41 42 12 11 30 30 12 11 43 44 12 11 43 44 12 11 12 41 42 43 44 11 41 42 11 20 20 20 20 41 42 11 12 41
41 42 11 12 11 20 20 20 20 20 20 20 43 44 41 42 43 44 41 42 30 30 41 42 45 46 41 42 45 46 41 42 11 43 44 45 46 12 43 44 12 20 20 20 20 43 44 41 42 43
43 44 12 11 12 20 20 20 20 20 20 20 45 46 43 44 45 46 43 44 30 30 43 44 47 48 43 44 47 48 43 44 12 45 46 47 48 11 45 46 11 20 20 20 20 45 46 43 44 45
45 46 11 12 11 20 20 20 20 20 20 20 47 48 45 46 47 48 45 46 30 30 45 46 11 12 45 46 11 12 45 46 11 47 48 11 12 11 47 48 12 20 20 20 20 47 48 45 46 47
47 48 12 11 12 20 20 20 20 20 20 20 11 12 47 48 11 12 47 48 30 30 47 48 12 11 47 48 12 11 47 48 11 12 11 12 11 12 11 12 11 20 20 20 20 11 12 47 48 11